1 14 17
9 9 9 9 9 9 3 9 9 9 9 9 9 9 9 9 9 9 9 9 9 3 9 9 9 9 9 9
9 0 0 0 0 0 0 0 0 0 0 0 0 0 0 0 0 0 0 0 0 0 0 0 0 0 0 9
9 0 9 9 9 9 0 9 9 9 9 9 0 9 9 0 9 9 9 9 9 0 9 9 9 9 0 9
9 1 9 9 9 9 0 9 9 9 9 9 0 9 9 0 9 9 9 9 9 0 9 9 9 9 1 9
9 0 9 9 9 9 0 9 9 9 9 9 0 9 9 0 9 9 9 9 9 0 9 9 9 9 0 9
9 0 0 0 0 0 0 0 0 0 0 0 0 0 0 0 0 0 0 0 0 0 0 0 0 0 0 9
9 0 9 9 9 9 0 9 9 0 9 9 0 9 9 0 9 9 0 9 9 0 9 9 9 9 0 9
9 0 9 9 9 9 0 9 9 0 9 9 0 9 9 0 9 9 0 9 9 0 9 9 9 9 0 9
3 0 0 0 0 0 0 9 9 0 0 0 0 0 0 0 0 0 0 9 9 0 0 0 0 0 0 3
9 0 9 9 9 9 0 9 9 9 9 9 0 9 9 0 9 9 9 9 9 0 9 9 9 9 0 9
9 0 0 0 0 0 0 9 9 9 9 9 0 9 9 0 9 9 9 9 9 0 0 0 0 0 0 9
9 0 9 9 9 9 0 0 0 2 2 2 2 2 4 2 2 2 2 0 0 0 9 9 9 9 0 9
9 0 0 0 0 0 0 9 9 2 9 9 9 9 6 9 9 9 2 9 9 0 0 0 0 0 0 9
9 0 9 9 9 9 0 9 9 2 9 9 9 9 5 9 9 9 2 9 9 0 9 9 9 9 0 9
3 0 0 0 0 0 0 0 0 2 9 9 9 9 9 9 9 9 2 0 0 0 0 0 0 0 0 3
9 0 9 9 9 9 0 9 9 2 9 9 9 9 9 9 9 9 2 9 9 0 9 9 9 9 0 9
9 0 9 9 9 9 0 9 9 2 9 9 9 9 9 9 9 9 2 9 9 0 9 9 9 9 0 9
9 0 0 0 0 0 0 9 9 2 2 2 2 2 2 2 2 2 2 9 9 0 0 0 0 0 0 9
9 0 9 9 9 9 0 9 9 0 9 9 9 9 9 9 9 9 0 9 9 0 9 9 9 9 0 9
9 0 9 9 9 9 0 9 9 0 9 9 9 9 9 9 9 9 0 9 9 0 9 9 9 9 0 9
3 0 0 0 0 0 0 0 0 0 0 0 0 9 9 0 0 0 0 0 0 0 0 0 0 0 0 3
9 0 9 0 9 9 0 9 9 0 9 9 0 9 9 0 9 9 0 9 9 0 9 9 0 9 0 9
9 0 9 0 9 9 0 9 9 0 9 9 0 9 9 0 9 9 0 9 9 0 9 9 0 9 0 9
9 1 0 0 9 9 0 0 0 0 0 0 0 0 0 0 0 0 0 0 0 0 0 0 0 0 1 9
9 9 9 0 9 9 0 9 9 0 9 9 9 9 9 9 9 9 0 9 9 0 9 9 0 9 9 9
9 9 9 0 9 9 0 9 9 0 9 9 9 9 9 9 9 9 0 9 9 0 9 9 0 9 9 9
3 0 0 0 0 0 0 0 0 0 0 0 0 0 0 0 0 0 0 0 0 0 0 0 0 0 0 3
9 0 9 9 9 9 0 9 9 0 9 9 0 9 9 0 9 9 0 9 9 0 9 9 9 9 0 9
9 0 9 9 9 9 0 9 9 0 9 9 0 9 9 0 9 9 0 9 9 0 9 9 9 9 0 9
9 0 0 0 0 0 0 0 0 0 0 0 0 0 0 0 0 0 0 0 0 0 0 0 0 0 0 9
9 9 9 9 9 9 3 9 9 9 9 9 9 9 9 9 9 9 9 9 9 3 9 9 9 9 9 9
0-kropka
1-du¿a kropka
2-pusta przestrzeñ
3-tunel
4-wierzcho³ek przy wyjœciu
5-wierzcho³ek w œrodku
6-droga miêdzy wnêtrzem a wyjœciem
9-œciana