1 14 17
9 9 9 9 9 9 9 9 9 9 9 9 9 9 9 9 9 9 9 9 9 9 9 9 9 9 9 9
9 0 0 0 0 0 0 0 0 0 0 0 0 0 0 0 0 0 0 0 0 0 0 0 0 0 0 9
9 1 9 9 9 9 9 9 9 0 9 9 9 9 9 9 9 9 0 9 0 9 0 9 0 9 1 9
9 0 9 9 9 9 9 0 0 0 9 9 9 9 9 9 9 9 0 9 0 9 0 9 0 9 0 9
9 0 9 9 9 0 0 0 9 0 9 9 0 0 0 0 9 9 0 9 0 9 0 9 0 9 0 9
9 0 9 0 0 0 9 0 9 0 9 9 0 9 9 0 9 9 0 9 0 9 0 9 0 9 0 9
9 0 9 0 9 0 9 0 9 0 9 0 0 0 0 0 0 9 0 9 0 9 0 9 0 9 0 9
9 0 9 0 0 0 9 0 9 0 9 0 9 9 9 9 0 9 0 9 0 9 0 9 0 9 0 9
9 0 9 9 9 0 0 0 9 0 0 0 0 0 0 0 0 0 0 9 0 9 0 9 0 9 0 9
9 0 9 9 9 9 9 0 0 0 9 9 9 9 9 9 9 9 0 0 0 9 0 9 0 0 0 9
9 0 9 9 9 9 9 9 9 0 9 9 9 9 9 9 9 9 0 9 9 9 0 9 9 9 0 9
3 0 0 0 0 0 0 0 0 2 2 2 2 2 4 2 2 2 2 0 0 0 0 0 0 0 0 3
9 0 9 9 9 0 9 9 9 2 9 9 9 9 6 9 9 9 2 9 9 9 0 9 9 9 0 9
9 0 9 0 0 0 0 0 9 2 9 9 9 9 5 9 9 9 2 9 0 0 0 0 0 9 0 9
9 0 9 0 9 0 9 0 9 2 9 9 9 9 9 9 9 9 2 9 0 9 0 9 0 9 0 9
9 0 9 0 0 0 0 0 9 2 9 9 9 9 9 9 9 9 2 9 0 0 0 0 0 9 0 9
9 0 9 9 9 0 9 9 9 2 9 9 9 9 9 9 9 9 2 9 9 9 0 9 9 9 0 9
9 0 0 0 0 0 0 0 0 2 2 2 2 2 2 2 2 2 2 0 0 0 0 0 0 0 0 9
9 0 9 9 0 9 0 9 9 0 9 9 9 9 9 9 9 9 0 9 0 9 9 9 0 9 0 9
9 0 9 9 0 9 0 9 9 0 9 9 9 9 9 9 9 9 0 9 0 9 9 9 0 9 0 9
9 0 9 9 0 0 0 9 9 0 0 0 0 0 0 0 0 0 0 9 0 0 0 0 0 9 0 9
9 0 9 9 9 9 9 9 9 0 9 9 9 9 9 9 9 9 0 9 9 9 9 9 9 9 0 9
9 0 0 0 9 9 9 0 0 0 0 0 0 0 0 0 0 9 0 0 0 9 9 9 0 0 0 9
9 0 9 0 9 9 9 0 9 0 9 0 9 9 0 9 0 9 0 9 0 9 9 9 0 9 0 9
9 0 9 0 9 9 9 0 9 0 9 0 9 9 0 9 0 9 0 0 0 9 9 9 0 0 0 9
9 0 0 0 9 9 9 0 0 0 9 0 0 0 0 9 0 9 0 9 9 9 9 9 9 9 0 9
9 0 9 9 9 9 9 9 9 0 9 9 9 9 9 9 0 9 0 9 0 0 0 0 0 9 0 9
9 0 9 9 0 0 0 9 9 0 0 0 0 0 0 0 0 9 0 9 0 9 9 9 0 9 0 9
9 1 9 9 0 9 0 9 9 0 9 9 9 9 9 9 9 9 0 9 0 9 9 9 0 9 1 9
9 0 0 0 0 0 0 0 0 0 0 0 0 0 0 0 0 0 0 0 0 0 0 0 0 0 0 9
9 9 9 9 9 9 9 9 9 9 9 9 9 9 9 9 9 9 9 9 9 9 9 9 9 9 9 9
0-kropka
1-du¿a kropka
2-pusta przestrzeñ
3-tunel
4-owoc
5-pocz¹tek grafu
6-wejœcie do domku
7-domek
8-graf w domku
9-œciana